NO textures/new/north.xpm  
SO textures/new/south.xpm  
WE textures/new/east.xpm  
EA textures/new/west.xpm  

F 194,160,128  
C 217,179,119  

111111111111111111111
1000000000000000000E1
111111111111111111111
